⠀⢀⣀⡀⠀⠀⠀⠀⠀⠀⠀⠀⠀⠀⠀⠀⢀⣀⡀⠀
⠀⣿⣉⣿⣀⣀⣀⣀⣀⣠⣄⣀⣀⣀⣀⣀⣿⣉⣿⠀
⠀⣿⣤⣤⣤⣤⣤⣤⣤⣼⣧⣤⣤⣤⣤⣤⣤⣤⣿⠀
⠀⣿⠀⣿⠀⠀⠀⠀⠀⢸⡇⠀⠀⠀⠀⠀⣿⠀⣿⠀
⠀⣿⠀⣿⠀⠀⠀⢠⡶⠛⠛⢶⡄⠀⠀⠀⣿⠀⣿⠀
⠀⣿⠀⣿⠀⠀⠀⢿⡷⠶⠶⢾⡿⠀⠀⠀⣿⠀⣿⠀
⠀⣿⠀⣿⠀⠀⠀⢸⣇⣀⣀⣸⡇⠀⠀⠀⣿⠀⣿⠀
⠀⣿⠀⣿⠀⠀⠀⠀⠉⠉⠉⠉⠀⠀⠀⠀⣿⠀⣿⠀
⠀⣿⠀⣿⠀⠀⠀⠀⠀⠀⠀⠀⠀⠀⠀⠀⣿⠀⣿⠀
⣴⠟⠒⠛⠒⠒⠒⠒⠒⠒⠒⠒⠒⠒⠒⠒⠛⠒⠻⣦
⠙⣿⠛⠛⠛⢻⡟⠛⠛⢻⡟⠛⠛⢻⡟⠛⠛⠛⣿⠋
⠀⣿⠛⣿⠛⠛⠛⢻⡟⠛⠛⢻⡟⠛⠛⠛⣿⠛⣿⠀
⠀⣿⠛⠛⠛⣻⡟⠛⠛⢻⡟⠛⠛⢻⣟⠛⠛⠛⣿⠀
⠀⣿⣉⣿⣋⣉⣉⣻⣏⣉⣉⣹⣟⣉⣉⣙⣿⣉⣿⠀
⠀⠈⠉⠉⠉⠉⠉⠉⠉⠉⠉⠉⠉⠉⠉⠉⠉⠉⠁⠀